#L##################
#R\\\\\\\\\\\\\\\\\#
#\\\\\\\\\\\\\\\\\\#
#\\\\\\\\\\\\\\\\\\#
#\\\\\\\\\\\\\\\\\\#
#\\\\\\\\\\\\\\\\\\#
#\\\\\\\\\\\\\\\\\\#
#\\\\\\\\\\\\\\\\\\#
#\\\\\\\\\\\\\\\\\\#
#\\\\\\\\\\\\\\\\\\#
#\\\\\\\\\\\\\\\\\\#
#\\\\\\\\\\\\\\\\\\#
#\\\\\\\\\\\\\\\\\\#
#\\\\\\\\\\\\\\\\\\#
#\\\\\\\\\\\\\\\\\\#
#\\\\\\\\\\\\\\\\\\#
#\\\\\\\\\\\\\\\\\\#
#\\\\\\\\\\\\\\\\\\#
#\\\\\\\\\\\\\\\\\\#
#\\\\\\\\\\\\\\\\\\#
#\\\\\\\\\\\\\\\\\\#
#\\\\\\\\\\\\\\\\\\#
####################
