#L########
#R\\\\\\\#
#\\\\\\\\#
#\\\\\\\\#
#\\\\\\\\#
#\\\\\\\\#
#\\\\\\\\#
#\\\\\\\\#
#\\\\\\\\#
#\\\\\\\\#
#\\\\\\\\#
#\\\\\\\\#
##########
